diameter-of-n-ary-tree	true
move-sub-tree-of-n-ary-tree	true
find-root-of-n-ary-tree	true
find-a-value-of-a-mysterious-function-closest-to-target	false
maximum-number-of-non-overlapping-substrings	false
number-of-nodes-in-the-sub-tree-with-the-same-label	false
water-bottles	false
design-a-file-sharing-system	true
best-position-for-a-service-centre	false
number-of-substrings-with-only-1s	false
number-of-good-pairs	false
clone-n-ary-tree	true
minimum-possible-integer-after-at-most-k-adjacent-swaps-on-digits	false
count-submatrices-with-all-ones	false
last-moment-before-all-ants-fall-out-of-a-plank	false
can-make-arithmetic-progression-from-sequence	false
clone-binary-tree-with-random-pointer	true
max-value-of-equation	false
number-of-subsequences-that-satisfy-the-given-sum-condition	false
check-if-array-pairs-are-divisible-by-k	false
path-crossing	false
delete-n-nodes-after-m-nodes-of-a-linked-list	true
stone-game-iv	false
minimum-difference-between-largest-and-smallest-value-in-three-moves	false
range-sum-of-sorted-subarray-sums	false
find-critical-and-pseudo-critical-edges-in-minimum-spanning-tree	false
avoid-flood-in-the-city	false
making-file-names-unique	false
xor-operation-in-an-array	false
find-all-the-lonely-nodes	true
minimum-number-of-days-to-make-m-bouquets	false
least-number-of-unique-integers-after-k-removals	false
running-sum-of-1d-array	false
parallel-courses-ii	false
longest-subarray-of-1s-after-deleting-one-element	false
the-kth-factor-of-n	false
average-salary-excluding-the-minimum-and-maximum-salary	false
paint-house-iii	false
design-browser-history	false
the-k-strongest-values-in-an-array	false
shuffle-the-array	false
probability-of-a-two-boxes-having-the-same-number-of-distinct-balls	false
reorder-routes-to-make-all-paths-lead-to-the-city-zero	false
maximum-area-of-a-piece-of-cake-after-horizontal-and-vertical-cuts	false
maximum-product-of-two-elements-in-an-array	false
find-two-non-overlapping-sub-arrays-each-with-target-sum	false
subrectangle-queries	false
allocate-mailboxes	false
final-prices-with-a-special-discount-in-a-shop	false
max-dot-product-of-two-subsequences	false
pseudo-palindromic-paths-in-a-binary-tree	false
maximum-number-of-vowels-in-a-substring-of-given-length	false
check-if-a-word-occurs-as-a-prefix-of-any-word-in-a-sentence	false
maximum-number-of-darts-inside-of-a-circular-dartboard	false
people-whose-list-of-favorite-companies-is-not-a-subset-of-another-list	false
rearrange-words-in-a-sentence	false
number-of-students-doing-homework-at-a-given-time	false
cherry-pickup-ii	false
course-schedule-iv	false
check-if-a-string-contains-all-binary-codes-of-size-k	false
make-two-arrays-equal-by-reversing-sub-arrays	false
number-of-ways-of-cutting-a-pizza	false
minimum-time-to-collect-all-apples-in-a-tree	false
count-triplets-that-can-form-two-arrays-of-equal-xor	false
build-an-array-with-stack-operations	false
find-the-kth-smallest-sum-of-a-matrix-with-sorted-rows	false
longest-continuous-subarray-with-absolute-diff-less-than-or-equal-to-limit	false
check-if-all-1s-are-at-least-length-k-places-away	false
destination-city	false
form-largest-integer-with-digits-that-add-up-to-target	false
count-good-nodes-in-binary-tree	false
simplified-fractions	false
consecutive-characters	false
diagonal-traverse-ii	false
maximum-points-you-can-obtain-from-cards	false
maximum-score-after-splitting-a-string	false
build-array-where-you-can-find-the-maximum-exactly-k-comparisons	false
minimum-number-of-frogs-croaking	false
display-table-of-food-orders-in-a-restaurant	false
reformat-the-string	false
number-of-ways-to-wear-different-hats-to-each-other	false
check-if-a-string-can-break-another-string	false
max-difference-you-can-get-from-changing-an-integer	false
kids-with-the-greatest-number-of-candies	false
number-of-ways-to-paint-n-3-grid	false
html-entity-parser	false
queries-on-a-permutation-with-key	false
string-matching-in-an-array	false
stone-game-iii	false
number-of-steps-to-reduce-a-number-in-binary-representation-to-one	false
minimum-subsequence-in-non-increasing-order	false
restore-the-array	false
the-k-th-lexicographical-string-of-all-happy-strings-of-length-n	false
find-the-minimum-number-of-fibonacci-numbers-whose-sum-is-k	false
minimum-value-to-get-positive-step-by-step-sum	false
find-all-good-strings	false
design-underground-system	false
count-number-of-teams	false
find-lucky-integer-in-an-array	false
longest-happy-prefix	false
check-if-there-is-a-valid-path-in-a-grid	false
create-target-array-in-the-given-order	false
reducing-dishes	false
construct-k-palindrome-strings	false
circle-and-rectangle-overlapping	false
count-largest-group	false
maximum-performance-of-a-team	false
find-a-corresponding-node-of-a-binary-tree-in-a-clone-of-that-tree	false
design-a-stack-with-increment-operation	false
lucky-numbers-in-a-matrix	false
frog-position-after-t-seconds	false
time-needed-to-inform-all-employees	false
bulb-switcher-iii	false
generate-a-string-with-characters-that-have-odd-counts	false
pizza-with-3n-slices	false
sort-integers-by-the-power-value	false
cinema-seat-allocation	false
find-the-distance-value-between-two-arrays	false
minimum-cost-to-make-at-least-one-valid-path-in-a-grid	false
linked-list-in-binary-tree	false
rank-teams-by-votes	false
how-many-numbers-are-smaller-than-the-current-number	false
construct-target-array-with-multiple-sums	false
maximum-number-of-events-that-can-be-attended	false
product-of-the-last-k-numbers	false
count-negative-numbers-in-a-sorted-matrix	false
maximum-sum-bst-in-binary-tree	false
longest-zigzag-path-in-a-binary-tree	false
find-the-longest-substring-containing-vowels-in-even-counts	false
increasing-decreasing-string	false
maximum-students-taking-exam	false
tweet-counts-per-frequency	false
minimum-number-of-steps-to-make-two-strings-anagram	false
check-if-n-and-its-double-exist	false
jump-game-v	false
maximum-product-of-splitted-binary-tree	false
reduce-array-size-to-the-half	false
the-k-weakest-rows-in-a-matrix	false
count-all-valid-pickup-and-delivery-options	false
number-of-substrings-containing-all-three-characters	false
apply-discount-every-n-orders	false
sort-integers-by-the-number-of-1-bits	false
minimum-difficulty-of-a-job-schedule	false
find-the-city-with-the-smallest-number-of-neighbors-at-a-threshold-distance	false
filter-restaurants-by-vegan-friendly-price-and-distance	false
remove-palindromic-subsequences	false
minimum-number-of-taps-to-open-to-water-a-garden	false
delete-leaves-with-a-given-value	false
print-words-vertically	false
maximum-69-number	false
jump-game-iv	false
angle-between-hands-of-a-clock	false
number-of-sub-arrays-of-size-k-and-average-greater-than-or-equal-to-threshold	false
number-of-steps-to-reduce-a-number-to-zero	false
minimum-distance-to-type-a-word-using-two-fingers	false
number-of-operations-to-make-network-connected	false
minimum-flips-to-make-a-or-b-equal-to-c	false
convert-integer-to-the-sum-of-two-no-zero-integers	false
minimum-insertion-steps-to-make-a-string-palindrome	false
get-watched-videos-by-your-friends	false
xor-queries-of-a-subarray	false
decrypt-string-from-alphabet-to-integer-mapping	false
check-if-a-string-is-a-valid-sequence-from-root-to-leaves-path-in-a-binary-tree	true
verbal-arithmetic-puzzle	false
jump-game-iii	false
all-elements-in-two-binary-search-trees	false
find-n-unique-integers-sum-up-to-zero	false
maximum-candies-you-can-get-from-boxes	false
maximum-number-of-occurrences-of-a-substring	false
divide-array-in-sets-of-k-consecutive-numbers	false
find-numbers-with-even-number-of-digits	false
shortest-path-in-a-grid-with-obstacles-elimination	false
maximum-side-length-of-a-square-with-sum-less-than-or-equal-to-threshold	false
convert-binary-number-in-a-linked-list-to-integer	false
minimum-number-of-flips-to-convert-binary-matrix-to-zero-matrix	false
find-the-smallest-divisor-given-a-threshold	false
group-the-people-given-the-group-size-they-belong-to	false
subtract-the-product-and-sum-of-digits-of-an-integer	false
print-immutable-linked-list-in-reverse	true
palindrome-partitioning-iii	false
count-square-submatrices-with-all-ones	false
number-of-burgers-with-no-waste-of-ingredients	false
find-winner-on-a-tic-tac-toe-game	false
number-of-ways-to-stay-in-the-same-place-after-some-steps	false
search-suggestions-system	false
count-servers-that-communicate	false
minimum-time-visiting-all-points	false
counting-elements	true
minimum-moves-to-move-a-box-to-their-target-location	false
greatest-sum-divisible-by-three	false
find-elements-in-a-contaminated-binary-tree	false
shift-2d-grid	false
maximum-score-words-formed-by-letters	false
number-of-closed-islands	false
reconstruct-a-2-row-binary-matrix	false
cells-with-odd-values-in-a-matrix	false
leftmost-column-with-at-least-a-one	true
check-if-it-is-a-good-array	false
minimum-remove-to-make-valid-parentheses	false
count-number-of-nice-subarrays	false
minimum-swaps-to-make-strings-equal	false
first-unique-number	true
airplane-seat-assignment-probability	false
tiling-a-rectangle-with-the-fewest-squares	false
maximum-length-of-a-concatenated-string-with-unique-characters	false
circular-permutation-in-binary-representation	false
find-positive-integer-solution-for-a-given-equation	false
maximum-profit-in-job-scheduling	false
replace-the-substring-for-balanced-string	false
remove-sub-folders-from-the-filesystem	false
check-if-it-is-a-straight-line	false
perform-string-shifts	true
maximum-equal-frequency	false
dice-roll-simulation	false
queens-that-can-attack-the-king	false
split-a-string-in-balanced-strings	false
design-skiplist	false
count-vowels-permutation	false
path-with-maximum-gold	false
longest-arithmetic-subsequence-of-given-difference	false
play-with-chips	false
path-with-maximum-probability	false
minimum-moves-to-reach-target-with-rotations	false
get-equal-substrings-within-budget	false
remove-all-adjacent-duplicates-in-string-ii	false
unique-number-of-occurrences	false
sort-items-by-groups-respecting-dependencies	false
smallest-string-with-swaps	false
ugly-number-iii	false
minimum-absolute-difference	false
longest-happy-string	false
critical-connections-in-a-network	false
k-concatenation-maximum-sum	false
reverse-substrings-between-each-pair-of-parentheses	false
maximum-number-of-balloons	false
kth-ancestor-of-a-tree-node	false
make-array-strictly-increasing	false
day-of-the-week	false
maximum-subarray-sum-with-one-deletion	false
distance-between-bus-stops	false
constrained-subsequence-sum	false
balance-a-binary-search-tree	false
four-divisors	false
reformat-date	false
number-of-valid-words-for-each-puzzle	false
can-make-palindrome-from-substring	false
diet-plan-performance	true
prime-arrangements	false
largest-multiple-of-three	false
closest-divisors	false
validate-binary-tree-nodes	false
number-of-days-between-two-dates	false
compare-strings-by-frequency-of-the-smallest-character	false
invalid-transactions	false
web-crawler	true
dinner-plate-stacks	false
remove-zero-sum-consecutive-nodes-from-linked-list	false
number-of-dice-rolls-with-target-sum	false
online-majority-element-in-subarray	false
swap-for-longest-repeated-character-substring	false
day-of-the-year	false
rank-transform-of-an-array	false
reverse-subarray-to-maximize-array-value	false
deepest-leaves-sum	false
sort-the-matrix-diagonally	false
break-a-palindrome	false
longest-chunked-palindrome-decomposition	false
longest-common-subsequence	false
snapshot-array	false
binary-tree-coloring-game	false
decrease-elements-to-make-array-zigzag	false
distinct-echo-substrings	false
sum-of-nodes-with-even-valued-grandparent	false
matrix-block-sum	false
decompress-run-length-encoded-list	false
stone-game-ii	false
largest-1-bordered-square	false
alphabet-board-path	false
n-th-tribonacci-number	false
number-of-paths-with-max-score	false
number-of-ships-in-a-rectangle	true
sum-of-mutated-array-closest-to-target	false
replace-elements-with-greatest-element-on-right-side	false
maximum-of-absolute-value-expression	false
shortest-path-with-alternating-colors	false
minimum-cost-tree-from-leaf-values	false
number-of-equivalent-domino-pairs	false
minimum-falling-path-sum-ii	false
remove-covered-intervals	false
element-appearing-more-than-25-in-sorted-array	false
smallest-sufficient-team	false
longest-well-performing-interval	false
lowest-common-ancestor-of-deepest-leaves	false
relative-sort-array	false
handshakes-that-dont-cross	true
sequential-digits	false
iterator-for-combination	false
maximum-nesting-depth-of-two-valid-parentheses-strings	false
delete-nodes-and-return-forest	false
corporate-flight-bookings	false
defanging-an-ip-address	false
palindrome-removal	true
delete-tree-nodes	true
remove-interval	true
hexspeak	true
parsing-a-boolean-expression	false
filling-bookcase-shelves	false
distribute-candies-to-people	false
path-in-zigzag-labelled-binary-tree	false
divide-chocolate	true
synonymous-sentences	true
smallest-common-region	true
encode-number	true
brace-expansion-ii	false
find-in-mountain-array	false
car-pooling	false
statistics-from-a-large-sample	false
valid-palindrome-iii	true
tree-diameter	true
design-a-leaderboard	true
array-transformation	true
shortest-path-in-binary-matrix	false
shortest-common-supersequence	false
largest-values-from-labels	false
duplicate-zeros	false
minimum-time-to-build-blocks	true
toss-strange-coins	true
meeting-scheduler	true
missing-number-in-arithmetic-progression	true
letter-tile-possibilities	false
smallest-subsequence-of-distinct-characters	false
insufficient-nodes-in-root-to-leaf-paths	false
occurrences-after-bigram	false
maximum-number-of-ones	true
stepping-numbers	true
two-sum-bsts	true
intersection-of-three-sorted-arrays	true
adding-two-negabinary-numbers	false
flip-columns-for-maximum-number-of-equal-rows	false
greatest-common-divisor-of-strings	false
number-of-submatrices-that-sum-to-target	false
optimize-water-distribution-in-a-village	true
find-smallest-common-element-in-all-rows	true
minimum-knight-moves	true
how-many-apples-can-you-put-into-the-basket	true
distant-barcodes	false
previous-permutation-with-one-swap	false
grumpy-bookstore-owner	false
height-checker	false
shortest-distance-to-target-color	true
last-substring-in-lexicographical-order	false
before-and-after-puzzle	true
count-substrings-with-only-one-distinct-letter	true
last-stone-weight-ii	false
longest-string-chain	false
remove-all-adjacent-duplicates-in-string	false
last-stone-weight	false
minimum-cost-to-connect-sticks	true
design-file-system	true
string-transforms-into-another-string	true
single-row-keyboard	true
longest-duplicate-substring	false
partition-array-for-maximum-sum	false
flower-planting-with-no-adjacent	false
robot-bounded-in-circle	false
divide-array-into-increasing-sequences	true
as-far-from-land-as-possible	false
maximum-level-sum-of-a-binary-tree	false
valid-boomerang	false
binary-search-tree-to-greater-sum-tree	false
moving-stones-until-consecutive-ii	false
find-words-that-can-be-formed-by-characters	false
minimum-score-triangulation-of-polygon	false
analyze-user-website-visit-pattern	true
minimum-swaps-to-group-all-1s-together	true
escape-a-large-maze	false
uncrossed-lines	false
coloring-a-border	false
moving-stones-until-consecutive	false
check-if-a-number-is-majority-element-in-a-sorted-array	true
parallel-courses	true
connecting-cities-with-minimum-cost	true
path-with-maximum-minimum-value	true
largest-unique-number	true
stream-of-characters	false
maximum-sum-of-two-non-overlapping-subarrays	false
two-city-scheduling	false
matrix-cells-in-distance-order	false
recover-a-tree-from-preorder-traversal	false
maximum-difference-between-node-and-ancestor	false
maximum-average-subtree	true
armstrong-number	true
remove-vowels-from-a-string	true
number-of-days-in-a-month	true
longest-arithmetic-sequence	false
divisor-game	false
the-earliest-moment-when-everyone-become-friends	true
find-k-length-substrings-with-no-repeated-characters	true
two-sum-less-than-k	true
sum-of-digits-in-the-minimum-number	true
video-stitching	false
camelcase-matching	false
sum-of-root-to-leaf-binary-numbers	false
remove-outermost-parentheses	false
confusing-number-ii	true
brace-expansion	true
index-pairs-of-a-string	true
high-five	true
number-of-enclaves	false
next-greater-node-in-linked-list	false
binary-prefix-divisible-by-5	false
convert-to-base-2	false
confusing-number	true
digit-count-in-range	true
campus-bikes-ii	true
fixed-point	true
binary-string-with-substrings-representing-1-to-n	false
smallest-integer-divisible-by-k	false
best-sightseeing-pair	false
partition-array-into-three-parts-with-equal-sum	false
number-of-valid-subarrays	true
longest-repeating-substring	true
missing-element-in-sorted-array	true
lexicographically-smallest-equivalent-string	true
numbers-with-repeated-digits	false
capacity-to-ship-packages-within-d-days	false
pairs-of-songs-with-total-durations-divisible-by-60	false
complement-of-base-10-integer	false
minimize-rounding-error-to-meet-target	true
campus-bikes	true
shortest-way-to-form-string	true
construct-binary-search-tree-from-preorder-traversal	false
minimum-domino-rotations-for-equal-row	false
clumsy-factorial	false
maximize-sum-of-array-after-k-negations	false
max-consecutive-ones-iii	false
check-if-word-is-valid-after-substitutions	false
find-common-characters	false
grid-illumination	false
minimum-cost-to-merge-stones	false
available-captures-for-rook	false
maximum-binary-tree-ii	false
find-the-town-judge	false
number-of-squareful-arrays	false
minimum-number-of-k-consecutive-bit-flips	false
rotting-oranges	false
cousins-in-binary-tree	false
subarrays-with-k-different-integers	false
broken-calculator	false
satisfiability-of-equality-equations	false
add-to-array-form-of-integer	false
smallest-string-starting-from-leaf	false
vertical-order-traversal-of-a-binary-tree	false
interval-list-intersections	false
sum-of-even-numbers-after-queries	false
string-without-aaa-or-bbb	false
minimum-cost-for-tickets	false
triples-with-bitwise-and-equal-to-zero	false
time-based-key-value-store	false
unique-paths-iii	false
distribute-coins-in-binary-tree	false
longest-turbulent-subarray	false
squares-of-a-sorted-array	false
largest-perimeter-triangle	false
odd-even-jump	false
subarray-sums-divisible-by-k	false
k-closest-points-to-origin	false
fibonacci-number	false
equal-rational-numbers	false
flip-binary-tree-to-match-preorder-traversal	false
powerful-integers	false
pancake-sorting	false
binary-tree-cameras	false
numbers-with-same-consecutive-differences	false
vowel-spellchecker	false
univalued-binary-tree	false
least-operators-to-express-number	false
minimum-area-rectangle-ii	false
maximum-width-ramp	false
n-repeated-element-in-size-2n-array	false
delete-columns-to-make-sorted-iii	false
regions-cut-by-slashes	false
check-completeness-of-a-binary-tree	false
prison-cells-after-n-days	false
tallest-billboard	false
delete-columns-to-make-sorted-ii	false
array-of-doubled-pairs	false
verifying-an-alien-dictionary	false
largest-component-size-by-common-factor	false
flip-equivalent-binary-trees	false
reveal-cards-in-increasing-order	false
largest-time-for-given-digits	false
bag-of-tokens	false
most-stones-removed-with-same-row-or-column	false
validate-stack-sequences	false
minimum-increment-to-make-array-unique	false
delete-columns-to-make-sorted	false
find-the-shortest-superstring	false
di-string-match	false
valid-mountain-array	false
distinct-subsequences-ii	false
minimum-area-rectangle	false
range-sum-of-bst	false
reorder-data-in-log-files	false
stamping-the-sequence	false
knight-dialer	false
shortest-bridge	false
number-of-recent-calls	false
beautiful-array	false
minimum-falling-path-sum	false
binary-subarrays-with-sum	false
unique-email-addresses	false
minimize-malware-spread-ii	false
three-equal-parts	false
flip-string-to-monotone-increasing	false
long-pressed-name	false
minimize-malware-spread	false
3sum-with-multiplicity	false
sort-array-by-parity-ii	false
minimum-add-to-make-parentheses-valid	false
number-of-music-playlists	false
complete-binary-tree-inserter	false
maximum-sum-circular-subarray	false
reverse-only-letters	false
word-subsets	false
partition-array-into-disjoint-intervals	false
x-of-a-kind-in-a-deck-of-cards	false
cat-and-mouse	false
sort-an-array	false
online-election	false
smallest-range-ii	false
snakes-and-ladders	false
smallest-range-i	false
sum-of-subarray-minimums	false
super-palindromes	false
sort-array-by-parity	false
fruit-into-baskets	false
valid-permutations-for-di-sequence	false
numbers-at-most-n-given-digit-set	false
online-stock-span	false
rle-iterator	false
orderly-queue	false
bitwise-ors-of-subarrays	false
increasing-order-search-tree	false
monotonic-array	false
maximum-frequency-stack	false
all-possible-full-binary-trees	false
groups-of-special-equivalent-strings	false
surface-area-of-3d-shapes	false
sum-of-subsequence-widths	false
find-and-replace-pattern	false
construct-binary-tree-from-preorder-and-postorder-traversal	false
fair-candy-swap	false
super-egg-drop	false
possible-bipartition	false
spiral-matrix-iii	false
uncommon-words-from-two-sentences	false
projection-area-of-3d-shapes	false
reachable-nodes-in-subdivided-graph	false
boats-to-save-people	false
decoded-string-at-index	false
generate-random-point-in-a-circle	false
random-point-in-non-overlapping-rectangles	false
random-flip-matrix	false
random-pick-with-weight	false
profitable-schemes	false
nth-magical-number	false
stone-game	false
middle-of-the-linked-list	false
koko-eating-bananas	false
walking-robot-simulation	false
length-of-longest-fibonacci-subsequence	false
leaf-similar-trees	false
implement-rand10-using-rand7	false
minimum-number-of-refueling-stops	false
advantage-shuffle	false
reordered-power-of-2	false
binary-gap	false
transpose-matrix	false
prime-palindrome	false
smallest-subtree-with-all-the-deepest-nodes	false
shortest-path-to-get-all-keys	false
random-pick-with-blacklist	false
all-nodes-distance-k-in-binary-tree	false
shortest-subarray-with-sum-at-least-k	false
score-after-flipping-matrix	false
lemonade-change	false
buddy-strings	false
mirror-reflection	false
minimum-cost-to-hire-k-workers	false
score-of-parentheses	false
exam-room	false
k-similar-strings	false
car-fleet	false
peak-index-in-a-mountain-array	false
loud-and-rich	false
rectangle-area-ii	false
maximize-distance-to-closest-person	false
shifting-letters	false
shortest-path-visiting-all-nodes	false
hand-of-straights	false
longest-mountain-in-array	false
backspace-string-compare	false
guess-the-word	false
split-array-into-fibonacci-sequence	false
keys-and-rooms	false
magic-squares-in-grid	false
similar-string-groups	false
push-dominoes	false
new-21-game	false
rectangle-overlap	false
robot-room-cleaner	true
image-overlap	false
sum-of-distances-in-tree	false
find-and-replace-in-string	false
flipping-an-image	false
design-circular-queue	false
design-circular-deque	false
masking-personal-information	false
positions-of-large-groups	false
consecutive-numbers-sum	false
count-unique-characters-of-all-substrings-of-a-given-string	false
making-a-large-island	false
most-profit-assigning-work	false
friends-of-appropriate-ages	false
goat-latin	false
insert-into-a-sorted-circular-linked-list	true
binary-trees-with-factors	false
card-flipping-game	false
shortest-distance-to-a-character	false
short-encoding-of-words	false
design-linked-list	false
most-common-word	false
race-car	false
linked-list-components	false
ambiguous-coordinates	false
bus-routes	false
binary-tree-pruning	false
largest-sum-of-averages	false
largest-triangle-area	false
subdomain-visit-count	false
chalkboard-xor-game	false
expressive-words	false
soup-servings	false
max-increase-to-keep-city-skyline	false
number-of-lines-to-write-string	false
split-array-with-same-average	false
unique-morse-code-words	false
bricks-falling-when-hit	false
find-eventual-safe-states	false
minimum-swaps-to-make-sequences-increasing	false
similar-rgb-color	true
design-hashmap	false
design-hashset	false
champagne-tower	false
smallest-rotation-with-highest-score	false
all-paths-from-source-to-target	false
rotate-string	false
number-of-subarrays-with-bounded-maximum	false
valid-tic-tac-toe-state	false
preimage-size-of-factorial-zeroes-function	false
number-of-matching-subsequences	false
custom-sort-string	false
domino-and-tromino-tiling	false
escape-the-ghosts	false
rotated-digits	false
cheapest-flights-within-k-stops	false
k-th-smallest-prime-fraction	false
is-graph-bipartite	false
letter-case-permutation	false
minimum-distance-between-bst-nodes	false
transform-to-chessboard	false
rabbits-in-forest	false
reaching-points	false
k-th-symbol-in-grammar	false
swim-in-rising-water	false
swap-adjacent-in-lr-string	false
binary-search	false
split-bst	true
global-and-local-inversions	false
kth-largest-element-in-a-stream	false
minimize-max-distance-to-gas-station	true
sliding-puzzle	false
search-in-a-sorted-array-of-unknown-size	true
basic-calculator-iii	true
insert-into-a-binary-search-tree	false
search-in-a-binary-search-tree	false
jewels-and-stones	false
basic-calculator-iv	false
max-chunks-to-make-sorted	false
max-chunks-to-make-sorted-ii	false
reorganize-string	false
toeplitz-matrix	false
n-ary-tree-postorder-traversal	false
n-ary-tree-preorder-traversal	false
maximum-depth-of-n-ary-tree	false
logical-or-of-two-binary-grids-represented-as-quad-trees	false
construct-quad-tree	false
encode-n-ary-tree-to-binary-tree	true
couples-holding-hands	false
largest-plus-sign	false
partition-labels	false
prime-number-of-set-bits-in-binary-representation	false
flatten-a-multilevel-doubly-linked-list	false
serialize-and-deserialize-n-ary-tree	true
n-ary-tree-level-order-traversal	false
special-binary-string	false
find-anagram-mappings	true
employee-free-time	true
bold-words-in-string	true
set-intersection-size-at-least-two	false
convert-binary-search-tree-to-sorted-doubly-linked-list	true
pyramid-transition-matrix	false
pour-water	true
reach-a-number	false
cracking-the-safe	false
open-the-lock	false
ip-to-cidr	true
number-of-corner-rectangles	true
contain-virus	false
shortest-completing-word	false
largest-number-at-least-twice-of-others	false
min-cost-climbing-stairs	false
prefix-and-suffix-search	false
find-smallest-letter-greater-than-target	false
network-delay-time	false
closest-leaf-in-a-binary-tree	true
to-lower-case	false
cherry-pickup	false
delete-and-earn	false
daily-temperatures	false
monotone-increasing-digits	false
sentence-similarity-ii	true
parse-lisp-expression	false
asteroid-collision	false
sentence-similarity	true
flood-fill	false
my-calendar-iii	false
my-calendar-ii	false
count-different-palindromic-subsequences	false
my-calendar-i	false
self-dividing-numbers	false
minimum-window-subsequence	true
number-of-atoms	false
split-linked-list-in-parts	false
find-pivot-index	false
candy-crush	true
remove-comments	false
accounts-merge	false
longest-word-in-dictionary	false
find-k-th-smallest-pair-distance	false
maximum-length-of-repeated-subarray	false
1-bit-and-2-bit-characters	false
max-stack	true
range-module	false
best-time-to-buy-and-sell-stock-with-transaction-fee	false
subarray-product-less-than-k	false
minimum-ascii-delete-sum-for-two-strings	false
number-of-distinct-islands-ii	true
falling-squares	false
partition-to-k-equal-sum-subsets	false
degree-of-an-array	false
count-binary-substrings	false
max-area-of-island	false
number-of-distinct-islands	true
binary-number-with-alternating-bits	false
top-k-frequent-words	false
stickers-to-spell-word	false
employee-importance	false
maximum-sum-of-3-non-overlapping-subarrays	false
knight-probability-in-chessboard	false
longest-univalue-path	false
repeated-string-match	false
redundant-connection-ii	false
redundant-connection	false
k-empty-slots	true
baseball-game	false
next-closest-time	true
valid-palindrome-ii	false
24-game	false
valid-parenthesis-string	false
map-sum-pairs	false
implement-magic-dictionary	false
cut-off-trees-for-golf-event	false
longest-continuous-increasing-subsequence	false
number-of-longest-increasing-subsequence	false
bulb-switcher-ii	false
second-minimum-node-in-a-binary-tree	false
maximum-swap	false
trim-a-binary-search-tree	false
kth-smallest-number-in-multiplication-table	false
beautiful-arrangement-ii	false
path-sum-iv	true
non-decreasing-array	false
strange-printer	false
equal-tree-partition	true
maximum-width-of-binary-tree	false
image-smoother	false
remove-9	true
split-array-into-consecutive-subsequences	false
find-k-closest-elements	false
robot-return-to-origin	false
coin-path	true
print-binary-tree	false
maximum-binary-tree	false
two-sum-iv-input-is-a-bst	false
find-duplicate-subtrees	false
4-keys-keyboard	true
2-keys-keyboard	false
dota2-senate	false
replace-words	false
palindromic-substrings	false
maximum-length-of-pair-chain	false
set-mismatch	false
maximum-average-subarray-ii	true
maximum-average-subarray-i	false
design-search-autocomplete-system	true
solve-the-equation	false
decode-ways-ii	false
shopping-offers	false
average-of-levels-in-binary-tree	false
exclusive-time-of-functions	false
design-log-storage-system	true
find-the-derangement-of-an-array	true
sum-of-square-numbers	false
smallest-range-covering-elements-from-k-lists	false
design-excel-sum-formula	true
course-schedule-iii	false
k-inverse-pairs-array	false
maximum-product-of-three-numbers	false
minimum-factorization	true
maximum-distance-in-arrays	true
add-one-row-to-tree	false
task-scheduler	false
merge-two-binary-trees	false
add-bold-tag-in-string	true
valid-triangle-number	false
find-duplicate-file-in-system	false
construct-string-from-binary-tree	false
can-place-flowers	false
design-compressed-string-iterator	true
non-negative-integers-without-consecutive-ones	false
minimum-index-sum-of-two-lists	false
range-addition-ii	false
longest-harmonious-subsequence	false
valid-square	false
fraction-addition-and-subtraction	false
tag-validator	false
design-in-memory-file-system	true
erect-the-fence	false
delete-operation-for-two-strings	false
kill-process	true
shortest-unsorted-continuous-subarray	false
out-of-boundary-paths	false
distribute-candies	false
squirrel-simulation	true
subtree-of-another-tree	false
maximum-vacation-days	true
permutation-in-string	false
reshape-the-matrix	false
array-nesting	false
find-the-closest-palindrome	false
binary-tree-tilt	false
longest-line-of-consecutive-one-in-matrix	true
array-partition-i	false
subarray-sum-equals-k	false
reverse-words-in-a-string-iii	false
next-greater-element-iii	false
split-concatenated-strings	true
brick-wall	false
optimal-division	false
student-attendance-record-ii	false
student-attendance-record-i	false
binary-tree-longest-consecutive-sequence-ii	true
split-array-with-equal-sum	true
friend-circles	false
remove-boxes	false
boundary-of-binary-tree	true
output-contest-matches	true
diameter-of-binary-tree	false
01-matrix	false
reverse-string-ii	false
single-element-in-a-sorted-array	false
minimum-time-difference	false
convert-bst-to-greater-tree	false
complex-number-multiplication	false
construct-binary-tree-from-string	true
encode-and-decode-tinyurl	false
lonely-pixel-ii	true
k-diff-pairs-in-an-array	false
lonely-pixel-i	true
minimum-absolute-difference-in-bst	false
minesweeper	false
word-abbreviation	true
beautiful-arrangement	false
contiguous-array	false
longest-word-in-dictionary-through-deleting	false
continuous-subarray-sum	false
longest-uncommon-subsequence-ii	false
longest-uncommon-subsequence-i	false
detect-capital	false
coin-change-2	false
super-washing-machines	false
longest-palindromic-subsequence	false
find-largest-value-in-each-tree-row	false
freedom-trail	false
find-bottom-left-tree-value	false
all-paths-from-source-lead-to-destination	true
inorder-successor-in-bst-ii	true
most-frequent-subtree-sum	false
perfect-number	false
relative-ranks	false
the-maze-ii	true
base-7	false
next-greater-element-ii	false
ipo	false
find-mode-in-binary-search-tree	false
keyboard-row	false
the-maze-iii	true
diagonal-traverse	false
next-greater-element-i	false
teemo-attacking	false
target-sum	false
reverse-pairs	false
construct-the-rectangle	false
increasing-subsequences	false
the-maze	true
zuma-game	false
max-consecutive-ones-ii	true
predict-the-winner	false
max-consecutive-ones	false
find-permutation	true
smallest-good-base	false
license-key-formatting	false
magical-string	false
sliding-window-median	false
largest-palindrome-product	false
total-hamming-distance	false
number-complement	false
heaters	false
ones-and-zeroes	false
matchsticks-to-square	false
concatenated-words	false
encode-string-with-shortest-length	true
convex-polygon	true
validate-ip-address	false
unique-substrings-in-wraparound-string	false
count-the-repetitions	false
optimal-account-balancing	true
can-i-win	false
island-perimeter	false
minimum-moves-to-equal-array-elements-ii	false
hamming-distance	false
lfu-cache	false
repeated-substring-pattern	false
poor-pigs	false
circular-array-loop	false
132-pattern	false
assign-cookies	false
4sum-ii	false
minimum-moves-to-equal-array-elements	false
minimum-number-of-arrows-to-burst-balloons	false
sort-characters-by-frequency	false
delete-node-in-a-bst	false
serialize-and-deserialize-bst	false
find-all-numbers-disappeared-in-an-array	false
number-of-boomerangs	false
arithmetic-slices-ii-subsequence	false
add-two-numbers-ii	false
sequence-reconstruction	true
string-compression	false
find-all-duplicates-in-an-array	false
arranging-coins	false
k-th-smallest-in-lexicographical-order	false
ternary-expression-parser	true
find-all-anagrams-in-a-string	false
path-sum-iii	false
find-right-interval	false
non-overlapping-intervals	false
number-of-segments-in-a-string	false
minimum-genetic-mutation	false
all-oone-data-structure	false
word-squares	true
longest-repeating-character-replacement	false
reconstruct-original-digits-from-english	false
valid-word-square	true
maximum-xor-of-two-numbers-in-an-array	false
strong-password-checker	false
battleships-in-a-board	false
sentence-screen-fitting	true
pacific-atlantic-water-flow	false
partition-equal-subset-sum	false
add-strings	false
third-maximum-number	false
arithmetic-slices	false
fizz-buzz	false
minimum-unique-word-abbreviation	true
split-array-largest-sum	false
longest-palindrome	false
valid-word-abbreviation	true
trapping-rain-water-ii	false
queue-reconstruction-by-height	false
convert-a-number-to-hexadecimal	false
sum-of-left-leaves	false
frog-jump	false
remove-k-digits	false
binary-watch	false
nth-digit	false
evaluate-division	false
random-pick-index	false
integer-replacement	false
rotate-function	false
longest-substring-with-at-least-k-repeating-characters	false
decode-string	false
utf-8-validation	false
is-subsequence	false
perfect-rectangle	false
elimination-game	false
find-the-difference	false
longest-absolute-file-path	false
first-unique-character-in-a-string	false
lexicographical-numbers	false
mini-parser	false
shuffle-an-array	false
ransom-note	false
linked-list-random-node	false
insert-delete-getrandom-o1-duplicates-allowed	false
insert-delete-getrandom-o1	false
design-phone-directory	true
kth-smallest-element-in-a-sorted-matrix	false
combination-sum-iv	false
wiggle-subsequence	false
guess-number-higher-or-lower-ii	false
guess-number-higher-or-lower	false
find-k-pairs-with-smallest-sums	false
super-pow	false
sum-of-two-integers	false
range-addition	true
plus-one-linked-list	true
largest-divisible-subset	false
valid-perfect-square	false
find-leaves-of-binary-tree	true
water-and-jug-problem	false
nested-list-weight-sum-ii	true
max-sum-of-rectangle-no-larger-than-k	false
design-hit-counter	true
bomb-enemy	true
sort-transformed-array	true
logger-rate-limiter	true
rearrange-string-k-distance-apart	true
count-numbers-with-unique-digits	false
line-reflection	true
design-twitter	false
russian-doll-envelopes	false
design-snake-game	true
data-stream-as-disjoint-intervals	false
android-unlock-patterns	true
intersection-of-two-arrays-ii	false
intersection-of-two-arrays	false
design-tic-tac-toe	true
top-k-frequent-elements	false
moving-average-from-data-stream	true
reverse-vowels-of-a-string	false
reverse-string	false
integer-break	false
power-of-four	false
flatten-nested-list-iterator	false
longest-substring-with-at-most-k-distinct-characters	true
nested-list-weight-sum	true
counting-bits	false
house-robber-iii	false
palindrome-pairs	false
self-crossing	false
increasing-triplet-subsequence	false
largest-bst-subtree	true
reconstruct-itinerary	false
verify-preorder-serialization-of-a-binary-tree	false
patching-array	false
longest-increasing-path-in-a-matrix	false
odd-even-linked-list	false
count-of-range-sum	false
power-of-three	false
maximum-size-subarray-sum-equals-k	true
wiggle-sort-ii	false
number-of-connected-components-in-an-undirected-graph	true
coin-change	false
create-maximum-number	false
generalized-abbreviation	true
bulb-switcher	false
maximum-product-of-word-lengths	false
shortest-distance-from-all-buildings	true
remove-duplicate-letters	false
count-of-smaller-numbers-after-self	false
binary-tree-vertical-order-traversal	true
super-ugly-number	false
burst-balloons	false
sparse-matrix-multiplication	true
minimum-height-trees	false
best-time-to-buy-and-sell-stock-with-cooldown	false
range-sum-query-2d-mutable	true
range-sum-query-mutable	false
additive-number	false
number-of-islands-ii	true
range-sum-query-2d-immutable	false
range-sum-query-immutable	false
smallest-rectangle-enclosing-black-pixels	true
remove-invalid-parentheses	false
longest-increasing-subsequence	false
bulls-and-cows	false
binary-tree-longest-consecutive-sequence	true
serialize-and-deserialize-binary-tree	false
best-meeting-point	true
find-median-from-data-stream	false
flip-game-ii	true
flip-game	true
nim-game	false
word-pattern-ii	true
word-pattern	false
game-of-life	false
unique-word-abbreviation	true
find-the-duplicate-number	false
walls-and-gates	true
inorder-successor-in-bst	true
peeking-iterator	false
move-zeroes	false
expression-add-operators	false
zigzag-iterator	true
wiggle-sort	true
perfect-squares	false
first-bad-version	false
find-the-celebrity	true
paint-fence	true
h-index-ii	false
h-index	false
integer-to-english-words	false
closest-binary-search-tree-value-ii	true
encode-and-decode-strings	true
closest-binary-search-tree-value	true
alien-dictionary	true
missing-number	false
palindrome-permutation-ii	true
palindrome-permutation	true
paint-house-ii	true
ugly-number-ii	false
ugly-number	false
graph-valid-tree	true
single-number-iii	false
3sum-smaller	true
add-digits	false
binary-tree-paths	false
paint-house	true
verify-preorder-sequence-in-binary-search-tree	true
factor-combinations	true
meeting-rooms-ii	true
meeting-rooms	true
flatten-2d-vector	true
count-univalue-subtrees	true
group-shifted-strings	true
strobogrammatic-number-iii	true
strobogrammatic-number-ii	true
strobogrammatic-number	true
shortest-word-distance-iii	true
shortest-word-distance-ii	true
shortest-word-distance	true
valid-anagram	false
different-ways-to-add-parentheses	false
search-a-2d-matrix-ii	false
sliding-window-maximum	false
product-of-array-except-self	false
delete-node-in-a-linked-list	false
lowest-common-ancestor-of-a-binary-tree	false
lowest-common-ancestor-of-a-binary-search-tree	false
palindrome-linked-list	false
number-of-digit-one	false
implement-queue-using-stacks	false
power-of-two	false
kth-smallest-element-in-a-bst	false
majority-element-ii	false
summary-ranges	false
basic-calculator-ii	false
invert-binary-tree	false
implement-stack-using-queues	false
basic-calculator	false
rectangle-area	false
count-complete-tree-nodes	false
maximal-square	false
contains-duplicate-iii	false
contains-duplicate-ii	false
the-skyline-problem	false
contains-duplicate	false
combination-sum-iii	false
kth-largest-element-in-an-array	false
shortest-palindrome	false
house-robber-ii	false
word-search-ii	false
add-and-search-word-data-structure-design	false
course-schedule-ii	false
minimum-size-subarray-sum	false
implement-trie-prefix-tree	false
course-schedule	false
reverse-linked-list	false
isomorphic-strings	false
count-primes	false
remove-linked-list-elements	false
happy-number	false
bitwise-and-of-numbers-range	false
number-of-islands	false
binary-tree-right-side-view	false
house-robber	false
number-of-1-bits	false
reverse-bits	false
rotate-array	false
best-time-to-buy-and-sell-stock-iv	false
repeated-dna-sequences	false
reverse-words-in-a-string-ii	true
largest-number	false
dungeon-game	false
binary-search-tree-iterator	false
factorial-trailing-zeroes	false
excel-sheet-column-number	false
two-sum-iii-data-structure-design	true
majority-element	false
excel-sheet-column-title	false
two-sum-ii-input-array-is-sorted	false
fraction-to-recurring-decimal	false
compare-version-numbers	false
maximum-gap	false
missing-ranges	true
find-peak-element	false
one-edit-distance	true
intersection-of-two-linked-lists	false
longest-substring-with-at-most-two-distinct-characters	true
read-n-characters-given-read4-ii-call-multiple-times	true
read-n-characters-given-read4	true
binary-tree-upside-down	true
min-stack	false
find-minimum-in-rotated-sorted-array-ii	false
find-minimum-in-rotated-sorted-array	false
maximum-product-subarray	false
reverse-words-in-a-string	false
evaluate-reverse-polish-notation	false
max-points-on-a-line	false
sort-list	false
insertion-sort-list	false
lru-cache	false
binary-tree-postorder-traversal	false
binary-tree-preorder-traversal	false
reorder-list	false
linked-list-cycle-ii	false
linked-list-cycle	false
word-break-ii	false
word-break	false
copy-list-with-random-pointer	false
single-number-ii	false
single-number	false
candy	false
gas-station	false
clone-graph	false
palindrome-partitioning-ii	false
palindrome-partitioning	false
surrounded-regions	false
sum-root-to-leaf-numbers	false
longest-consecutive-sequence	false
word-ladder	false
word-ladder-ii	false
valid-palindrome	false
binary-tree-maximum-path-sum	false
best-time-to-buy-and-sell-stock-iii	false
best-time-to-buy-and-sell-stock-ii	false
best-time-to-buy-and-sell-stock	false
triangle	false
pascals-triangle-ii	false
pascals-triangle	false
populating-next-right-pointers-in-each-node-ii	false
populating-next-right-pointers-in-each-node	false
distinct-subsequences	false
flatten-binary-tree-to-linked-list	false
path-sum-ii	false
path-sum	false
minimum-depth-of-binary-tree	false
balanced-binary-tree	false
convert-sorted-list-to-binary-search-tree	false
convert-sorted-array-to-binary-search-tree	false
binary-tree-level-order-traversal-ii	false
construct-binary-tree-from-inorder-and-postorder-traversal	false
construct-binary-tree-from-preorder-and-inorder-traversal	false
maximum-depth-of-binary-tree	false
binary-tree-zigzag-level-order-traversal	false
binary-tree-level-order-traversal	false
symmetric-tree	false
same-tree	false
recover-binary-search-tree	false
validate-binary-search-tree	false
interleaving-string	false
unique-binary-search-trees	false
unique-binary-search-trees-ii	false
binary-tree-inorder-traversal	false
restore-ip-addresses	false
reverse-linked-list-ii	false
decode-ways	false
subsets-ii	false
gray-code	false
merge-sorted-array	false
scramble-string	false
partition-list	false
maximal-rectangle	false
largest-rectangle-in-histogram	false
remove-duplicates-from-sorted-list	false
remove-duplicates-from-sorted-list-ii	false
search-in-rotated-sorted-array-ii	false
remove-duplicates-from-sorted-array-ii	false
word-search	false
subsets	false
combinations	false
minimum-window-substring	false
sort-colors	false
search-a-2d-matrix	false
set-matrix-zeroes	false
edit-distance	false
simplify-path	false
climbing-stairs	false
sqrtx	false
text-justification	false
add-binary	false
plus-one	false
valid-number	false
minimum-path-sum	false
unique-paths-ii	false
unique-paths	false
rotate-list	false
permutation-sequence	false
spiral-matrix-ii	false
length-of-last-word	false
insert-interval	false
merge-intervals	false
jump-game	false
spiral-matrix	false
maximum-subarray	false
n-queens-ii	false
n-queens	false
powx-n	false
group-anagrams	false
rotate-image	false
permutations-ii	false
permutations	false
jump-game-ii	false
wildcard-matching	false
multiply-strings	false
trapping-rain-water	false
first-missing-positive	false
combination-sum-ii	false
combination-sum	false
count-and-say	false
sudoku-solver	false
valid-sudoku	false
search-insert-position	false
find-first-and-last-position-of-element-in-sorted-array	false
search-in-rotated-sorted-array	false
longest-valid-parentheses	false
next-permutation	false
substring-with-concatenation-of-all-words	false
divide-two-integers	false
implement-strstr	false
remove-element	false
remove-duplicates-from-sorted-array	false
reverse-nodes-in-k-group	false
swap-nodes-in-pairs	false
merge-k-sorted-lists	false
generate-parentheses	false
merge-two-sorted-lists	false
valid-parentheses	false
remove-nth-node-from-end-of-list	false
4sum	false
letter-combinations-of-a-phone-number	false
3sum-closest	false
3sum	false
longest-common-prefix	false
roman-to-integer	false
integer-to-roman	false
container-with-most-water	false
regular-expression-matching	false
palindrome-number	false
string-to-integer-atoi	false
reverse-integer	false
zigzag-conversion	false
longest-palindromic-substring	false
median-of-two-sorted-arrays	false
longest-substring-without-repeating-characters	false
add-two-numbers	false
two-sum	false
